╔════╦═════════╗
║.   ║         ║
║  ══╝ ╔═ ══╗  ║
║      ║    ║  ║
╠══════╣    ║  ║
║      ║ ══╦╝  ║
║ ║   +║   ║-  ║
║ ╚════╩══ ╚═══╣
║              ║
╠════════╗ ╔═══╣
║       -║ ║   ║
║ ╔══════╝ ║   ║
║ ║        ╚═ ═╣
║ ╚═══════     ║
║              ║
╚══════════════╝